...########
..##.#.####
.##..###..#
##.....####
#...@..#..#
###..###..#
..#..#....#
.##.##.#.##
.#......##
.#.....##
.#######